#############
#     #     #
##### # # ###
#     # #   #
# ##### ### #
# #     # # #
# # # # # # #
#   # # #   #
# ##### #####
#   #   #   #
### # ### # #
#   #     #  
#############
