#######
# #   #
# ### #
#     #
### ###
#      
#######
