#############
#         # #
####### # # #
#   #   #   #
# # ####### #
# #   #     #
# ### # #####
#   #   #   #
### ##### # #
#       # # #
# ####### # #
#         #  
#############
